{
  "name":"7657",
  "description":"",
  "structur":[
    [1,1,1,1,1,1,1,1,0,0],
    [1,0,0,0,0,0,0,0,0,0],
    [1,0,0,0,0,0,0,0,0,0],
    [1,0,0,0,0,0,0,0,0,0],
    [1,0,0,0,0,0,0,0,0,0],
    [1,0,0,0,0,0,0,0,0,0],
    [1,0,0,0,0,0,0,0,0,0],
    [1,0,0,0,0,0,0,0,0,0],
    [0,0,0,0,0,0,0,0,0,0],
    [0,0,0,0,0,0,0,0,0,0]
  ]
}